NO ./images/block.xpm

SO ./images/ruins.xpm

WE ./images/brickWall.xpm

EA ./images/wall1.xpm

F 50,10,50
C 0,0,100

 11111111111111
1000000000100001
100E010000000001
1000000000100001
 11101111111011
 10000000000001
 10000000000001
 11111111111111