NO ./images/wall.xpm
SO ./images/ender64.xpm
WE ./images/blue.xpm
EA ./images/white.xpm
F 50,10,50
C 0,0,100

 11111 
1000001
100E001
1010001
 11111 
