NO ./images/wall.xpm
SO ./images/wall2.xpm
WE ./images/wall3.xpm
EA ./images/wall4.xpm
F 255,0,255
C 255,0,0

 11111 
1000001
100E001
1010001
 11111 
