NO ./images/ruins_1.xpm

SO ./images/pilarwall.xpm

WE ./images/simpleWall.xpm

EA ./images/SimpleWall2.xpm

F 50,10,50
C 0,0,100

 111111111
10000000001
100E0100001
10000000001
 1111111111
