NO ./images/n.png
SO ./images/s.png
WE ./images/w.png
EA ./images/e.png
F 240,233,133
C 225,0,0

1111111
1000001
10W0001
1000001
1111111
111111N
