NO ./images/blue.xpm

SO ./images/blue1.xpm

WE ./images/blue2.xpm

EA ./images/blue3.xpm

F 47,79,79
C 255,248,220

111111111111111111 
100000000000001001
100000100000000001
100000000000W00001
111111111111111111 
