NO ./path_to_no

SO ./path_to_so

WE ./path_to_we

EA ./path_to_ea

F 202200,200,-200
C 200,222200,200

111111111111111111
100000000000000001
101111111111111111
