NO ./images/blue.xpm

SO ./images/blue1.xpm

WE ./images/blue2.xpm

EA ./images/blue3.xpm

F 139,69,19
C 135,206,250

111111111111111111 
100000000000000001
100000000000000001
100000000000W00001
111111111111111111 
