SO ./images/s.xpm
WE ./images/w.xpm
F 200,100,50
EA ./images/e.xpm
C 15,240,120
NO ./images/n.xpm

1111111
1001001
100N001
1000001
1111111
