SO ./images/s.xpm
WE ./images/w.xpm
F 255,255,255
EA ./images/e.xpm
C 255,255,0
NO ./images/n.xpm

1111111
1001001
100N001
1000001
1111111
